Фишечки :)

COLORS - настройки цветов и что с ними связано
ARCHIVE - архив
POPUPS - всплывающая панель
ELF - эльфовые функции... траффик и данные для нижней панели
NEW_MENU - графическое меню
SERVICE_DISCOVERY - диско
PRIVACY - списки приватности
SMILES - смайлы
ANTISPAM - антиспам
REQUEST_VOICE - пока не нужно... запрос голоса для визиторов
HISTORY - история сообщений
SE_LIGHT - подсветка на сониэроиках и нокиях
TEMPLATES - шаблоны
USER_KEYS - настройка комбинаций кнопок
AUTOSTATUS - автостатус
USE_ROTATOR - баллуны и прокрутка длинных строк
FILE_TRANSFER - передача файлов
LAST_MESSAGES - последние 5 входящих сообщений контакта(хранятся в rms)
CHECK_VERSION	- проверка обновлений
TRANSLIT - функции транслитерации
WMUC - без поддержки конференций
AUTODELETE - автоудаление сообщений
WSYSTEMGC - убрать автоочистку кучи
NICK_COLORS - раскрашивание ников
IMPORT_EXPORT - импорт/экспорт пользовательских данных
SECONDSTRING - дополнительная строка с подсказкой
CHANGE_TRANSPORT - смена транспорта(перенос контактов с одного транспорта на другой)
CONSOLE - XML консоль
CLIPBOARD - Буфер обмена
GRADIENT - градиенты
PEP - pubsub(user mood, user tune)
PEP_TUNE - получение инфо о музыке играющей у контактов
CAPTCHA - капча
STATS - статистика