/skins/skin.txt	sand
/skins/ï»¿ny.txt	NewYear
/skins/original.txt	original
/skins/black-orange.txt	Black&Orange
/skins/egypt.txt	egypt
/skins/emo.txt	emo
/skins/summer.txt	summer
/skins/vanuha.txt	vanuha
/skins/tkabber.txt	tkabber
/skins/night.txt	night
/skins/oz.txt	oz
/skins/semen.txt	semen
/skins/green.txt	green
/skins/navy.txt	navy
/skins/silver.txt	silver
/skins/cacao.txt	cacao
/skins/water.txt	water
/skins/ural.txt	ural
/skins/beeline.txt	beeline
/skins/black.txt	black
/skins/blue.txt	blue
/skins/gray.txt	gray
/skins/walkman.txt	walkman
/skins/walkman_snow.txt	walkman snow
/skins/opera.txt	opera
/skins/maxidax.txt	maxidax
/skins/scorpion.txt	scorpion
/skins/pozitive.txt	pozitive
/skins/classic.txt	classic
/skins/rio.txt	rio
/skins/Fallout.txt	Fallout
/skins/vesna.txt	vesna